WWWWWWWWWWWWWWWWWWWW
W......P...........W
W*WW.WWWW.WWWW.W.W.W
W.WW.WWWW.WWWW.W.*.W
W..............WWW.W
WWWWWWWWWWWWWWWW...W
W..............W.W.W
W.WWWWW.WWWWWW.W.W.W
W................W.W
W.WW-WW.WWWWWW.W.W.W
W.W-G-W.W..*...W.W.W
W.WWWWW.W.WWWW.W.W.W
W...F..........W.W.W
W...WWWW.W.W.W.W.W.W
WWW......W.W.W.W.W.W
W...WWWW.W.W.W*W.W.W
W*W........W.......W
WWWWWWWWWWWWWWWWWWWW
